#domain
hospital
#levelname
BFSFriendly
#colors
red: 0, 1, 2, 3
#initial
++++++++++++
+         ++
+    + +  ++
+ + 0+ +   +
+ ++++ +++ +
+     +   1+
+  ++      +
+ +       ++
+ + +++3  ++
+2   ++++ ++
++++++++++++
#goal
++++++++++++
+         ++
+    + +  ++
+ +  + +   +
+ ++++0+++ +
+     +    +
+  ++ 3    +
+ +2      ++
+ + +++   ++
+    ++++1++
++++++++++++
#end